#########################################################
#                                                       #
#  P  X O                                               #
#                                                       #
#                                                       #
#                                                       #
#                                                       #
#                                                       #
#                                                       #
#                                                       #
#                                                       #
#                                                       #
#                                                       #
#                                                       #
#                                                       #
#                                                       #
#                                                       #
#                                                       #
#                                                       #
#                                                       #
#                                                       #
#                                                       #
#                                                    #
#                                                       #
#                                                      #
#       #####                                           #
#                                                       #
#########################################################
